000000000000203000
000000000000001000
000200000200001000
000000000000001000
000020000000001000
200000000111111000
000000000100000000
004110000111100020
220010000000100000
220011111111100000
2 3 5
100 100 100
200 200 100 30 20